1111111111111
1CCCECCCCCCC1
1CCCCCCCCCCC1
1C1P11CCCCCC1
1111111111111