11111111111111111111111111111111111111111111111111111111111111111111111111111
10000000000000000000000111111111111111111111111111111111111111111111111111111
100100000C0000C10C1110C111111111111111111111111111111111111111111111111111111
100000000100010100000C0011111111111111111111111111111111111111111111111111111
1E0011000P0000010000C00111111111111111111111111111111111111111111111111111111
11100000010001010000000111111111111111111111111111111111111111111111111111111
100000000000000000000000000000000000000000000000000000000000000000000000000C1
11000000000000000000000111111111111111111111111111111111111111111111111111111
11111111111111111111111111111111111111111111111111111111111111111111111111111