111111111111111111111111111111111111111
1000000000000000001E1000000000000000001
101111011110111100101001111011110111101
101111011110111100101001111011110111101
101111011110111100101001111011110111101
101111011110111100101001111011110111101
100000000000000000000000000000000000001
100000C000000000000C0000000000000000001
100000000000000000000000000000000000001
101111011110111100101001111011110111101
1C1111C111101111001010011110111101111C1
101111011110111100101001111C11110111101
101111011110111100101001111011110111101
1000000000000000001P1000000000000000001
111111111111111111111111111111111111111