1111111111111111111111
1000000000000000000C11
1000000000000001000001
10000100C0000111000001
11111100001101C00000E1
1000C10000010001100001
100000000000000C1000P1
1111111111111111111111