1111111111111111111111111111111111
1000000000000000001E10000C00000001
1011110111101111001010011110111101
1011110111101111001010011110111101
1011110111101111001010011110111101
1011110111101111001010011110111101
1000000000000000000000000000000001
10000000000C0000000000000C0000C001
1000000000000000000000000000000001
1011110111101111001010011110111101
1011110111101111001010011110111101
10111101111C1111001010011110111101
101111C111101111001010011110111101
1000000000000000001P10000000000001
1111111111111111111111111111111111