11111111111111111111111
1E0000000000000C0000001
10000101001000001001001
10000100000000000001011
1P0000000C00C0000000001
11111111111111111111111