1111111111111111
1PEC000000000001
1000000000000001
1000000000000001
1000000000000C01
1000000000000001
1111111111111111